DEEEEEEE
WEEWEEEE
WWWWEEEE
EWEWEWEE
WWWEEWEA
